1111111111111111
10000000C1000001
1P00000000000001
1E00000000000001
1111111111111111