11111111111111111111111111111111111111
100C000C000C000C000C0000C000C000C00C01
10000111000000111000011001100001110001
10001000100000100100011001100001000001
1P0010001000001110000110011000001000E1
10001000100000100000011001100000010001
10000111000000100000001111000001110001
100C000C000C000C000C0000C000C00C00C001
11111111111111111111111111111111111111