11111111111111111111
1CCCC1CCCCCCCC1CCCC1
1C11C1C111111C1C1EC1
1C1CCCCCCCCCCCCCC1C1
1C1C11C110011C11C1C1
1C1C11C111111C11C1C1
1C1CCCCC0P0CCCCCC1C1
1C11C1C111110C1C11C1
1CCCC1CCCCCCCC1CCCC1
11111111111111111111